C  79, 90, 110
F 252, 191, 23
NO ./assets/edbernar.xpm
NO ./assets/axdubois.xpm
WE ./assets/tomoron.xpm
EA ./assets/ycontre.xpm

 1111111   1   1 1
 1011101  101 1 1 1
 1001001   1 1 101 1
 1000N01       101
 10000011111111101
 10000000000000001
 1111111111111111
 10101010101010101     
  10101010101010101     
 10101010101010101     
  10101010101010101     
 10101010101010101     
  1 1 1 1 1 1 1 1 1     
